1110111011100-
0010101010100-
0010101010100-
0010101010100-
0010101010100-
0010101010100-
0011101110111-
0000000000000