00000000000000000-
11101110111011100-
00101010101010100-
00101010101010100-
00101010101010100-
00101010101010100-
00101010101010100-
00111011101110111-
00000000000000000